xxxxxxxxxxxxxxxx
x xs      xs  sx
x              x
x  v  v   x vv x
x              x
xsxvxs  v   xv x
xv             x
xxx xx x xvs   x
x          svxxx
x     vv      fx
x s v          x
xxxxxxxxxxxxxxxx
